#######################################################################################################################################################################################################################################
#===........==========================================================================================================================================================================================================================#
#==.........==========================================================================================================================================================================================================================#
#=.......=========...............................==============..............==================================================================.....========================================================================..........#
#=.......====.......................................................................==================================================....................=================================...........................................#
#=.....=====............................................................................=====================================...............................................============.....................................=========#
#.=..........................................................................................=======================............................................................=======.....====...===================================#
#....................=========================.....................=========......................===============.................................................................=====...======....==================================#
#....====........=================================================================.......................=======.........................=============................................===========.......==============================#
#==========.....=====================================================================.......................====................========================================.................=========.........============............===#
#==============================.........==================================================..............................====================================================.............=============.........=======................#
#========................................======================================================......................==========================================================..........================......===.......=========.....
#.............................................=======================================================.............==================================================================................=======............==============..
#....................................................====================================================.........===============================================.............==========............................==================#
#...............................................................................=============================================================================..................=========..========...........=========================#
#............................................................................................=======================================................................=========..=======================================================#
#................................====..............................................................................======...............................................=================================.......................======#
#............========================.........................................................................................................................................========================................................#
#=========================================..................................................................................................................................................======....................................#
#================================================......................................................................................==========================.....................................................................#
#=====================================================...........=========......................===============.............=========================================........................................===============..........#
#==========================================================================================================================================================================...............................============================#
#=======================================================================================================================================================================================.............=================================#
#######################################################################################################################################################################################################################################
