###################################################################################################################################################################################
#.................................................................................................................................................................................#
#.................................................................................................................................................................................#
#.................................................................................................................................................................................#
#.................................................................................................................................................................................#
#.................................................................................................................................................................................#
#.....................................................######......................................................................................................................#
#.....................................................######......................................................................................................................#
#....................................................#######......................................................................................................................#
#.................................###########################.....................................................................................................................#
#.............................##################################.......########...................................................................................................#
#............................######......................####################################................................................................................######
#............................#......#####...................####################################################.......########.....................................###############
#..............................###########################........................#.##############################...###################...........................###########....#
#.............................##################################..........#######..........#################.........############################.............#######.............#
#.........................#############...................................#############........########.............###############################################...............#
#..##..########################.............................................##################................###################################################.................#
######..####################...........................................................#############.......############################################################....########
#####..............................................................####........................#############################..########################################.....########
########..........................................................#######...........................................................#################################.....#########
#......####........................................................###########..........................................................................#############....##########
#.........###.............##................................######################..#########.#####........##.............##.##...................................................#
#.......................##.###################################################################################.###################.##..###########................................#
###################################################################################################################################################################################
