################################################################################################################################
#......................................====.....................................................................................
#......................................=..=.....................................................................................
#......................................=..=..........................========..................................................#
#......................................=..=..........................=......=.................................................+#
#......................................=..=..........................=......=...........................................++++++.#
#......................................=.............................................................................++++......#
#................................................................................................................+++++.........#
#........................................===........................==========...............................++++...............
#.......................................==.=.......................===......====..........................++++..................
#......................................==..==.....................==.=......======.....................+++....................##
#.....................................==....=....................==..=......======...................++......................###
#....................................#######=.................######.=......######................+++..........#################
#..................................##############..........########################..###.......###########...###################
################################################################################################............####################
################################################################################################################################
