################################################################################################################################
#..............................................................................................................................#
#..............................................................................................................................#
#..............................................................................................................................#
#.................................................##...........................................................................#
#..............=.................................#.#.#.........................................................................#
#.........=====.................................#......#.......................................................................#
#.......===...........+...##..................##.........#..#.#................................................................#
#......==.............+.##.#.#.#.#.#.###.....##................#.###...........................................................#
#......=..............+#....#.#.........#####..................................................................................#
#...........+++++++++++.###.....#.#.#.#............#...........................................................................#
#....+++++++...............###########.################.##.#...................................................................#
#......................................................#.#.##########..........................................................#
#..............................................................................................................................#
#..............................................................................................................................#
################################################################################################################################
