################################################################################################################################
###########....................................................................................................................#
########...####................................................................................................................#
########.......###.............................................................................................................#
########..........##.....................................#######...............................................................#
########...................................###############.....##.............................................................##
########..............................#####......................###.........................................................###
########..........####............####..............................#...................................................########
########..........#####.......####...................................##...............................................##########
#######.........#########################..............................##............................................###########
###..........################################............................###.......................................#############
##........#####........############....##....###.........###...............########......................###......##############
##......###.....................................#########..######.............#######...............############################
#........................................................................................####.....##############################
#.......................................................................................########################################
################################################################################################################################
