################################################################################################################################
#..................................................................#......#....................................................#
#..................................................................#......#....................................................#
#..................................................................#......#....................................................#
#..................................................................#......#....................................................#
#..................................................................#......#....................................................#
#..................................................................#......#....................................................#
#..................................................................#......#....................................................#
#..................................................................#...........................................................#
#..................................................................#...........................................................#
#..................................................................#.....#############.........................................#
#..........................................##......................#....#.#...........##################.......................#
#.........................................####.....................#...#..#............................###.....................#
#.........................................########.................#..#...#..............................###...................#
#..............................########################............#.#....#................................##..................#
################################################################################################################################
