################################################################################################################################
#.........................===.===.====.........................................................................................#
#.........................=............===.....................................................................................#
#.........................=..............=.....................................................................................#
#.......................=.==.............=.....................................................................................#
#.........................=..............=.....................................................................................#
#.........................=............===.....................................................................................#
#.........................=..........===.=.....................................................................................#
#.........................=........===...=.....................................................................................#
#.........................=......===.....=.....................................................................................#
#.........................=.....==.......=.....................................................................................#
#.........................=..===.........=...........................................................##################........#
#.........................====...........=...............#####################...............#############################.....#
#..............#######################################################################......##################################.#
################################################################################################################################
################################################################################################################################
